#######
#   # #
# # # #
#   # #
#######
